1111111111111
10000000000C1
1000011000001
10000110000E1
10000P0000001
1111111111111