1111111111111
10X00000000C1
1000011000001
10000110000E1
10000P0X00001
1111111111111
