1111111111111
1C00000000001
10X000000X0C1
10000110X0001
1X000110000E1
10000P0X00001
1000000000001
1111111111111